11111111111111
100000CP0001C1
100CC111100001
10000CCC111111
1E0000000CC111
11111111111111